########################################
#S ##  #     ###                 ##    #
## #     # #   # ###### ###  ### #  ####
#  # ### # # ### #    ### ## #         #
##   # ### # #   # # ##      ###########
####     ### # ### # #  #  #  #        #
#     ## #   #     # ## # ############ #
#####  ### ######### #  # #            #
#        # #         ## # ## ### ##### #
# ### ## # # #######  # #  # # #     # #
#   #  # # # #        # #### # ##### # #
### #### # # ### # #  #      #       # #
#   #    # #     ####### ##### ##### # #
### # # ## ##### #     #       #     # #
#   ###    ### # # # # ############### #
# #   ######## # # # #                 #
### # #        # # ######### ###########
#   #    ##### # #   #     #       #   #
# ########   ### # # # ##### # ### # ###
#          #     # #         #   #    E#
########################################