#############################################################
#S  #       #   # #     #       #       #           #   #   #
### ####### # # # # ### # ##### ####### # ######### # # # # #
#             # # #   # # #     #   #   #       #     # # # #
# ############# # ##### # ####### # ### ####### ####### # # #
#   #     #     #   #   #   #     #     #   #   #     # # # #
### # ### # ### # # # ##### # ########### # # # # # ### ### #
# # #   # # #   # # # #   # # #       #   # # # # # #       #
# # ### # # # ### ### # # # # # # ##### ##### # # ### #######
#   # # # # #     #   # # # # # #     #     # # #     #   # #
##### # # # ####### ### # # # # ##### ##### # ######### # # #
#   # # #   #   #     # #   # # #   #   # # #   #     # #   #
# # # # ####### ##### # ##### # ### ### # # ### # ### # # ###
# #   #   # #         #       #     #   # # #   # # # # #   #
# # ##### # # ####### ##### ######### ### # # ### # # # ### #
# #   # #       #   #   # #   #     #   # #       #   #   # #
# ### # ######### # ### # # # # ####### # ### ########### ###
#   #   #         # #       # # #     # #     #   #     #   #
### ### ######### # ##### ### # # ### # ##### # # # ### ### #
# #   #       #   #     # #   # # # #   #     # #     #     #
# ### ####### ### ##### # ##### # # # # # ##### #############
#   # #     #   #     #             # #   #   # #     #     #
### # # ####### ######### ####### ########### # # ### ##### #
#     # #     #               #   #         # #   # #   #   #
# ##### # ### ############### # ### ####### # ##### ### # ###
# #   # # # #             # # #     #   #   #     #   # #   #
### # # # # ##### # ##### # # ### ### ### ####### ### # # # #
#   #   #   #     # #   # #   #   # #   #           #     # #
# ##### ########### ### # ##### ### ### ######### # ### ### #
#     #                 #           #             #     #  E#
#############################################################