#####################################################################################################
#S#   #     #           #           #   #   #   #   #   #     #     #     #   #       #       #     #
# # # # ### # ######### # ######### ### # # # # ### # # # # # ##### # # # # # # ##### # ##### ##### #
# # #   #   # #   #   # #       #   #     # # #   # # #   # #       # # #   # #     # # #   #   # # #
# # ##### ### # # # # # ### ##### ### # ### # ### # # ##### ######### # ##### ####### # ### ### # # #
# #   # #     # # # # #     #     #   # # # #   #     #     #   #     # #   #       # # #   # # #   #
# ### # ####### # # ##### ### # ### ### # # ### ####### ##### # # ##### # # ##### # # # # ### # # # #
#     #   #     # # #   #   # # #   #   #   #     #     #     # #   #   # # #     #   #   # #   # # #
######### ##### # # # ##### ### # ############### # ##### ##### # ### ##### ### ####### ### # ##### #
#   #   # #     #   #       #   #       #         # #     # #   # #   #       #     # # #   # #     #
# # ### # # ################# ######### # ######### # ##### # ### # ######### ##### # # # # # # #####
# #     #         #       # #   #   #   #     #   #   #   #   #   #       #         #   # #   #     #
# ######### ##### # ##### # ### # # # ####### # # ####### ##### ######### ############### ##### # ###
#   #           #   #   #     # # #   #   #   # #     #   #   # #     # #   #     #   #   #   # #   #
### # ##### ### ##### # ##### # # # ### # # ### # ### # ### # # # # # # ### # # # # # # ### # # ### #
#   # #     # #       #   # #   # # #   # #   # #   # #   # #   # # #       # # # # # # #   # #   # #
# ##### ##### ####### ### # ####### # ### ### # ### # # # # ##### # ######### # # ### # # ### ### # #
# #   #   #     #     #   #   #   # # #   #     #   # # #   #     #       #   # # #   # #   # #   # #
# # # ### # # # # ##### ### ### # # # # ### # ### ##### ##### ########### # # ### # ### ### # # #####
#   #   #   # # #     #   #     # # # # #   #   #       #   # #       # #   # #   # #     # # # #   #
# ##### ##### ### ### ### ####### # # # # ### # ######### ### # ### # # ####### ### ##### ### # # # #
# #   #     #   # #   #   # #     #   #   #   #   #     #       #   # # #     #     #   #   # # # # #
### ####### ### ### ### ### # # ### ######### ### # ### ##### ####### # ### # ### ### # ### # # # ###
#   #     # #   #   # # #   # #   # #     #   #   # #   #     #     # #   # #   # #   #     # #     #
# ### ### # # ### ### # # # # ### # # # ### ### # # # ############# # # # # ### ### ######### # ### #
#       # #   #       #   # # # # # # #     #   # # #           #     # # # #     # #     #   # #   #
##### # ####### ######### # # # # # # ####### ##### ########### # ##### # ### # # # # ### # ##### ###
#     #   #   #   #       #   # #   #   #   #   #   #           #       #     # #     #     #   # # #
# ####### # ####### ########### ####### ### ### # ##### ####################### ### ### ####### # # #
#   #     #   #   #   #           #   #   # #   # #     #     #   #             #   # #   #       # #
### # ####### # # # # # ######### ### # # # # # # # ##### ### ### # ########### # ### ##### ####### #
# # #   #     # #   #   #       # #   # # # # # # #     # #   #   #   #       # # #         #   #   #
# # ### # ### # ### ######### # # # ### # # ### # ##### # # ### ##### # ##### ### # ######### # # # #
# #   # # # #     #       #   #   # # # #   #   #     #   #     # #   #     #   # #   #     # # # # #
# # # # # # ##### ####### # # ##### # # ##### ####### ########### # ####### ### # ### # ##### # ### #
#   # #   #     #   #     # #     # # # #   #       # #         #         # #     #   #       # #   #
# # # ######### ##### ##### ##### # # # # # ####### # # ####### ########### ####### ### ##### # # ###
# # #     #   #       #   #   #   # #   # #   #     #     #       #   #   #       # #   #     # #   #
### ##### # # # ####### ##### # ### ##### ### # ####### # # ####### # # # ####### # # ### ##### ### #
#   #     # # #   #   #       # #   # #   #   #     #   # # #     # # # # #   #   # #   # #   #     #
# ### ##### # ### # # ######### # ### # ### ####### # ### # # ### # # # # # # # # # ### # # # #######
#   #     # #   # # #       #     #   #   #   #   # # #   #   #   # #   # # #   # #   # # # # #   # #
######### # ### ### ### ### ####### ##### ### # # # ### ### ### ####### # ####### ### # ### # # # # #
#   # #   # #   #   #   #                   #   #       #   #   #     # # #     # # #     # # # #   #
# # # # ### ### # ####### # ####################### ##### ### ### ### ### # ### # # ### # # # ### ###
# # # #     #   #   #   # #       #     #   #       #   # #   # #   #     #   #   #   # #   # #     #
# # # ####### ####### # # # # ##### ### # # ########### # # ### ####### ##### ####### # ##### # ### #
# # #   #     #     # # # # #     # # # # #   # #         #     # #   # # #             #     #   # #
# ### # # ##### ### # ### # ##### # # # ##### # # # ############# # # # # # # ########### ####### # #
#     #         #   #     #     #   #         #   #                 #   #   #           #         #E#
#####################################################################################################